##@####
W#WW###
#W#####
###W###
#W##W##
#####P#