##@####
W##W###
#W#####
#####W#
#W##W##
#####P#